EA                          ./path_to_the_east_texture
NO                  ./path_to_the_north_texture
SO ./path_to_           the_south_texture



WE ./path_to   _the_west_texture


 C            225,30,0

            F 220,100,255

111111111111
    1N0001001111 111111
111111111111

ksdfh

