EA                          ./src/resources/decors/e.png
NO                  ./src/resources/decors/n.png
SO ./src/resources/decors/s.png

WE ./src/resources/decors/o.png


            F 220,100,255
 C            225,30,0

111111111111
    1000000011111 111111
111111101111
111100000111
    1S0000001111 111111
    100010001111 111111
    100001001111 111111
111111111111

