EA ./src/resources/decors/3.pngg
NO ./src/resources/decors/256_Marble01.png
SO ./src/resources/decors/256_Checkered01.png
WE ./src/resources/decors/256_Brick04.png
F 220,1eee00,12e

C 225,225,225

111  1
1E1 101
1111 111
10001111111
1111111111
