NO ./path_to_the_north_texture

SO              ./path_to_the_south_texture
WE ./path_to_the_west_texture



EA ./path           _to_the_east_texture
F               220,100,0

C 225,225,225



11111111111111
1000N000000001
10000000000001
10000000000001
10000000000001
10000000000001
10000000000001
10000000000001
10000000000001
11111111111111
