EA ./src/resources/decors/256_PathDirtVertical07.png
SO ./src/resources/decors/256_Checkered01.png


C 0,00,255


NO ./src/resources/decors/256_Marble01.png
F 0,255,0

WE ./src/resources/decors/256_Brick04.png


1111111111111111  1
1S00000000001    101
100000000001      1
100000000001 
100000000001            
100000000001        
100000000001 
1111111111111