


NO ./path_to_the_north_texture

SO              ./path_to_the_south_texture
WE ./path_to_the_west_texture



EA ./path           _to_the_east_texture
F               220,100,0
C 225,225,225
111111111111
1111111111 1
10000000E0011
100000000001
1000000000011
11111111111
1111000000111111111