EA ./src/resources/decors/3.png
NO ./src/resources/decors/256_Marble01.png
SO ./src/resources/decors/256_Checkered01.png
WE ./src/resources/decors/256_Brick04.png

C 220,100,120

F 225,225,225

111  11
11E1 101
1101 11
10001111111
1111111111
