NO ./path_to_the_north_texture

SO              ./path_to_the_south_texture
WE ./path_to_the_west_texture



EA ./path           _to_the_east_texture
F               220,100,0

C 225,225,225



111111111111
1000N0000001
111111111111