EA                          ./src/resources/decors/256_Cement01.png
NO                  ./src/resources/decors/256_Marble01.png
SO ./src/resources/decors/256_Checkered01.png



WE ./src/resources/decors/256_Brick04.png
F               220,100,0

C 225,225,225



11111111111111
1000N000000001
10110000110001
10100000100001
10000000000001
10000000000001
10000000000001
10000000000001
10000000000001
11111111111111
